55a618fd8000-55a618fd9000
55a618fd9000-55a618fda000
55a618fda000-55a618fdb000
55a618fdb000-55a618fdc000
55a618fdc000-55a618fdd000
7ff206a25000-7ff206a28000
7ff206a28000-7ff206a4e000
7ff206a4e000-7ff206ba3000
7ff206ba3000-7ff206bf6000
7ff206bf6000-7ff206bfa000
7ff206bfa000-7ff206bfc000
7ff206bfc000-7ff206c09000
7ff206c1a000-7ff206c1c000
7ff206c1c000-7ff206c1d000
7ff206c1d000-7ff206c42000
7ff206c42000-7ff206c4c000
7ff206c4c000-7ff206c4e000
7ff206c4e000-7ff206c50000
7fff6277c000-7fff6279d000
7fff627e2000-7fff627e6000
7fff627e6000-7fff627e8000
